               
           #### 
           #..# 
           #..# 
           #..# 
           #..# 
           #..# 
           #..# 
           #..# 
           #..#                     
          ##..###################### 
          #....####................# 
          #........................# 
          #........................# 
          #......##................# 
          #......##................# 
          #......##................# 
          ###..##########....####### 
           ##..##       ######       
           #....#             
           #....# 
           #....# 
           #....# 
           #....# 
           #....# 
           #....# 
           #....# 
           #....# 
           ##..## 
 ############..#### 
 #................# 
 #................# 
 #................# 
 #................# 
 #................# 
 #................# 
 #######....####### 
 #######P...####### 
       ######       
             