



                ####         
                #..#          
                #..#      
                #..#      
                #..#       
                #..#                      
                #..#                       
                #..#                      
                #..#                      
               ##..######################       
               #....####................#         
               #........................#        
               #........................#       
               #......##................#       
               #......##................#        
               #......##................#         
               ## .. #########....#######       
                 #..#         ######        
                #....#                     
                #....#                    
                #....#                    
                #....#          
                #....#       
                #....#         
                #....#         
                #....#         
                #....#         
                 #..#         
      ############..####           
      #................#        
      #................#        
      #................#          
      #................#        
      #................#         
      #................#       
      #######....#######        
            #P...#       
            ######       
                          
                        
