           ####
           #..#
           #..#
           #..#
           #..#
           #..#
           #..#
           #..#
           #..#    ############
          ##..######..........##
          #....................#
          #....................#
          #......###..........##
          #......# ############
          #......#
          #......#
          #......#
          ###..###
           ##..##
           #....#
           #....#
           #....#
           #....#
           #....#
           #....#
           #....#
           #....#
           #....#
           #....#
           #....#
 ############..##
##..............##
#................#
#................#
#................#
#................#
#................#
#................#
#######P...#######
      ######